1039112141-0:0
1039112141-1:0
1039112141-2:0
1039112141-3:0
1039112141-4:0
1039112141-5:0
